10 10 30 15
S 0 0 -1 0 0 0 0 0 G
0 0 4 0 -1 0 0 0 0 0
0 0 -1 0 0 0 2 0 0 0
0 0 0 0 0 -1 0 0 0 0
0 0 0 0 0 0 0 0 -1 0
0 0 0 -1 0 0 0 0 0 0
0 0 0 0 0 0 0 0 0 0
0 0 -1 0 0 0 0 0 -1 0
0 0 0 0 0 0 0 0 0 0
0 0 0 0 0 0 0 0 0 0